--------------
-ooo.---------
-oToooo-------
-ooooooooo----
--ooooooooo---
-------ooSoo--
-------ooo----
--------------
